XXXXXXXXXXXXXXXXXXXXXXXXXXX
XXXXXXXSXICXXXXXXXXICXXXXXX
XXXXXXIXXPPPIXXXIXXPPPIXXXX
XXXXXXPPPXXXPPPXPPPXXXPPPXX
XXXXXXXXXXXXXXXXXXXXXXXXXPX
XXXCXXCCCCXXXXXXXXXXXXXXXXX
TTTXXTTTTTXXTTTTTTTTXXTTTTT
TTTLLTTTTTLLTTTTTTTTLLTTTTT